Date,Description,Debit,Credit,Balance
2024-12-30,Job,2000.00,0.00,2000.00
2024-12-30,Trip,0.00,300.00,1700.00
2024-12-30,Gift,600.00,0.00,2300.00
2024-12-30,Incentive,1500.00,0.00,3800.00
2024-12-30,Gathering,0.00,100.00,3700.00
2024-12-30,Investment,0.00,1000.00,2700.00
